XOMOOOOXOOXOOOMOOO
OOOOOOOOOXOXMMOOXO
OOXXMOOOOOXOOXOOOO
OOMOOOOOOOOXOOOMOO
OOOXOOOOOOOOOOOOOO
XOOOOOOOOOOOXOXOOO
MXOOOOOOOOOOOOXOOO
XOOOOXXOOOOOMOOOOX
OOXXMOOOOOOOOMXMMO
OOOOOOXOOOOOOOOXOO
OOOXOXXXOOOXOOXXMO
OOOOOOXOXXOOOOXOXO
OXOOOOXOOOOOOOMOOO
XXOOOOXOMMXOOOOOOO
XOOOXOXOOOOOOXXOMO
XOOOXXOOOOOOOOOOOM
XOOXOOOOOOOOXOOOOO
OOOXOOXOOOOOOOMOXO
