XOOOOOXXOOOO
OOOOXOOOOOXO
OOOXOOOOXOOO
XOOXOOOOOOOO
OOXOMOOOOOXX
MOOOOOOOOOXO
OOOOMOOMMOOX
OOOOOOOOOOXM
OOOOOOOOOOOO
MOOOOOOOOOOO
OMOOOOOOOOOX
XOOOXOOOOOOM
